S....#..
.#.###I.
.#...E..
.E......
.#.#B#..
.#EI###.
.#B#.##.
I#G..EI.