S#G..B.E.#
.######.#.
..E##...#I
...#.#..#E
...#...#..
.#E...##..
..I##.EI..
#B#IE.#B..
#.#.....#.
#I#...I.#.