S.#G..B.E.#
E.######..#
..E##...#.I
.B.#.#..#.E
...#...#.E.
.#E...##.#B
.BI##..EI..
#B#IE.#.B..
#.#.....#E.
#I#...I.#.B